24 24 24 24 24 24 24 24 24 24 24 24 24 24 24 24 24 24 24 24 24 24 24 24 24 24 24 24 24 24 24 24 24 24 24 24
24 24 24 24 24 24 24 24 24 24 24 24 24 24 24 24 24 24 24 24 24 24 24 24 24 24 24 24 24 24 24 24 24 24 24 24
1 1 6 6 6 6 6 6 6 6 6 6 6 6 6 6 6 22 1 1 6 6 6 6 6 6 6 6 6 6 6 6 6 6 6 22
1 1 1 6 6 6 6 6 6 6 6 6 6 6 20 6 6 22 1 1 1 6 6 6 6 6 6 6 6 6 6 6 20 6 6 22
1 1 1 1 20 6 6 6 6 6 6 6 6 6 6 6 6 22 1 1 1 1 20 6 6 6 6 6 6 6 6 6 6 6 6 22
1 1 1 1 1 6 6 6 6 6 6 6 6 6 6 6 6 22 1 1 1 1 1 6 6 6 6 6 6 6 6 6 6 6 6 22
1 1 1 1 1 6 6 6 6 6 6 6 6 7 8 18 4 22 1 1 1 1 1 6 6 6 6 6 6 6 6 7 8 18 4 22
1 1 1 1 1 1 6 6 6 6 6 6 6 10 3 4 4 22 1 1 1 1 1 1 6 6 6 6 6 6 6 10 3 4 4 22
1 1 1 1 1 6 6 6 6 6 6 7 8 18 4 3 4 22 1 1 1 1 1 6 6 6 6 6 6 7 8 18 4 3 4 22
13 13 13 13 13 13 13 13 14 6 6 12 13 13 13 13 13 22 13 13 13 13 13 13 13 13 14 6 6 12 13 13 13 13 13 22
19 0 19 19 19 19 19 19 19 19 19 19 19 19 0 19 19 22 19 0 19 19 19 19 19 19 19 19 19 19 19 19 0 19 19 22
19 19 19 19 19 19 19 19 19 19 19 19 19 19 19 19 19 22 19 19 19 19 19 19 19 19 19 19 19 19 19 19 19 19 19 22
24 24 24 24 24 24 24 24 24 24 24 24 24 24 24 24 24 24 24 24 24 24 24 24 24 24 24 24 24 24 24 24 24 24 24 24
24 24 24 24 24 24 24 24 24 24 24 24 24 24 24 24 24 24 24 24 24 24 24 24 24 24 24 24 24 24 24 24 24 24 24 24
1 1 6 6 6 6 6 6 6 6 6 6 6 6 6 6 6 22 1 1 6 6 6 6 6 6 6 6 6 6 6 6 6 6 6 22
1 1 1 6 6 6 6 6 6 6 6 6 6 6 20 6 6 22 1 1 1 6 6 6 6 6 6 6 6 6 6 6 20 6 6 22
1 1 1 1 20 6 6 6 6 6 6 6 6 6 6 6 6 22 1 1 1 1 20 6 6 6 6 6 6 6 6 6 6 6 6 22
1 1 1 1 1 6 6 6 6 6 6 6 6 6 6 6 6 22 1 1 1 1 1 6 6 6 6 6 6 6 6 6 6 6 6 22
1 1 1 1 1 6 6 6 6 6 6 6 6 7 8 18 4 22 1 1 1 1 1 6 6 6 6 6 6 6 6 7 8 18 4 22
1 1 1 1 1 1 6 6 6 6 6 6 6 10 3 4 4 22 1 1 1 1 1 1 6 6 6 6 6 6 6 10 3 4 4 22
1 1 1 1 1 6 6 6 6 6 6 7 8 18 4 3 4 22 1 1 1 1 1 6 6 6 6 6 6 7 8 18 4 3 4 22
13 13 13 13 13 13 13 13 14 6 6 12 13 13 13 13 13 22 13 13 13 13 13 13 13 13 14 6 6 12 13 13 13 13 13 22
19 0 19 19 19 19 19 19 19 19 19 19 19 19 0 19 19 22 19 0 19 19 19 19 19 19 19 19 19 19 19 19 0 19 19 22
19 19 19 19 19 19 19 19 19 19 19 19 19 19 19 19 19 22 19 19 19 19 19 19 19 19 19 19 19 19 19 19 19 19 19 22