0 0 0 0 0 0 0 0 0 0 0 0 0 0 0 0 0 0 0 0 0 0 0 0 0 
0 0 0 0 0 0 0 0 0 0 0 0 0 0 0 0 0 0 0 0 0 0 0 0 0 
0 0 0 0 0 0 0 0 0 0 0 0 0 0 0 0 0 0 0 0 0 0 0 0 0 
0 0 0 0 0 0 0 0 0 0 0 0 0 0 0 0 5 11 11 11 11 4 0 0 0 
0 0 0 0 0 0 0 0 0 0 0 0 0 0 0 0 13 14 14 14 14 12 0 0 0 
0 0 0 0 0 0 0 0 0 0 0 0 0 0 0 0 13 16 14 17 14 12 0 0 0 
0 0 0 0 0 0 0 0 0 0 0 0 0 0 0 0 13 15 14 15 19 12 0 0 0 
0 0 0 0 0 0 0 0 0 0 0 0 0 0 0 0 13 23 24 23 24 12 0 0 0 
0 5 11 11 11 11 11 11 4 0 0 0 0 0 0 0 13 23 1 23 24 12 0 0 0 
0 13 24 24 24 24 24 24 12 0 0 0 0 5 11 11 3 23 24 23 24 12 0 0 0 
0 13 24 24 24 24 24 24 2 11 11 11 11 3 15 19 18 23 24 23 24 12 0 0 0 
0 13 24 24 24 24 24 24 21 21 22 22 22 22 22 22 22 27 22 27 22 12 0 0 0 
0 13 24 24 24 24 24 24 21 21 22 22 22 22 22 22 22 27 22 27 22 12 0 0 0 
0 13 24 24 24 24 24 24 8 10 10 10 10 9 24 1 24 23 24 23 24 12 0 0 0 
0 13 24 24 24 24 24 24 12 0 0 0 0 7 10 10 10 10 10 10 10 6 0 0 0 
0 7 10 10 10 10 10 10 6 0 0 0 0 0 0 0 0 0 0 0 0 0 0 0 0 
0 0 0 0 0 0 0 0 0 0 0 0 0 0 0 0 0 0 0 0 0 0 0 0 0 
0 0 0 0 0 0 0 0 0 0 0 0 0 0 0 0 0 0 0 0 0 0 0 0 0 
0 0 0 0 0 0 0 0 0 0 0 0 0 0 0 0 0 0 0 0 0 0 0 0 0 
0 0 0 0 0 0 0 0 0 0 0 0 0 0 0 0 0 0 0 0 0 0 0 0 0 
0 0 0 0 0 0 0 0 0 0 0 0 0 0 0 0 0 0 0 0 0 0 0 0 0 
